0100000000
0111100000
0110000000
0000000000
0000000000
